20 20
11110111111111111111
12000000000000000001
10000000000000000001
00000000000010000001
10000000000000000001
10000000000000000001
10001000010000000001
10000000000000000001
10000000010000000001
10000000011000000001
10000001111100000001
10000000000000000001
10000000000000000001
10000000000000000000
10000000000000000001
10000000000000000001
10000000000000000001
10000000010000000001
10000000100000000001
11111011111111111111


first line is map width and length
next <map length> lines describe the map
	0:	open
	1:	wall
	2:	player start
	anything else:	open
lines after <map length> + 1 are ignored