36 19
111111111111111111111111111111111111
110111111111111111111111111111111111
111111111111111111111111111111111111
111110000000000000000000000100001111
111110000100000000000000000000111111
111110001110000000000000000000001111
111110000100000000000000000001111111
111110000000000000200000000000000011
111100000000000000000000000000000011
111100000111110000000000000000000010
111100000100000000000000111110000011
111000000100100000000000100010000011
110000000000100000000000000000000011
110000000111100000000000100010000011
111000000000000000000100111110000011
110000000000000000000000000000000011
110000000000000000000000000000000011
110000000000000000000000000000000011
111111111111111111111111111111111111
